あ		expr.	Ah; oh
ああ		adv.	ah; yes
アフリカ		n.(kat.)	Africa
上がる	あがる	v.(u. i.)	to rise
挨拶	あいさつ	n.(suru)	to greet
味	あじ	n.	flavor; taste​; uniqueness; attractiveness; experience
アジア		n.(kat.)	Asia
赤ちゃん	あかちゃん	n.	baby; infant
赤ん坊	あかんぼう	n.	baby; infant
アクセサリー		n.(kat.)	accessory
アメリカ		n.(kat.)	America
アナウンサー		n.(kat.)	announcer
あんな		pren.	such
案内	あんない	n.(suru)	to guide
安心	あんしん	n.(na-adj. suru)	peace of mind
安全	あんぜん	n.(na-adj.)	safety; security​
アルバイト		n.(suru kat.)	part-time job
アルコール		n.(kat.)	alcohol
浅い	あさい	adj.(i-adj.)	shallow
遊び	あそび	n.	playing
集まる	あつまる	v.(u. i.)	to gather; to collect; to assemble
集める	あつめる	v.(ru. t.)	to collect; to assemble; to gather
謝る	あやまる	v.(u.)	to apologize
倍	ばい	n.	double
番組	ばんぐみ	n.	program (e.g. TV)
場所	ばしょ	n.	place
ベル		n.(kat.)	bell
美術館	びじゅつかん	n.	art gallery; art museum
びっくり		adv.(suru)	to be surprised
ビル		n.(kat.)	building
僕	ぼく	pron.	I (used by males)
貿易	ぼうえき	n.(suru)	trade
部長	ぶちょう	n.	manager; head (chief, director) of a section or department
ぶどう		n.	grapes
文学	ぶんがく	n.	literature
文化	ぶんか	n.	culture
文法	ぶんぽう	n.	grammar
ちゃん		suf.	suffix for familiar female person
チェック		n.(suru kat.)	to check
血	ち	n.	blood
力	ちから	n.	energy; force; strength; might; power
地理	ちり	n.	geography
中学校	ちゅうがっこう	n.	junior high school; middle school
注意	ちゅうい	n.(suru)	caution
注射	ちゅうしゃ	n.(suru)	injection
駐車場	ちゅうしゃじょう	n.	parking lot
大分	だいぶ	adv.	considerably; greatly; a lot​
大学生	だいがくせい	n.	university student; college student
大事	だいじ	adj.(na-adj.)	important; serious; crucial
大体	だいたい	n.	roughly
暖房	だんぼう	n.(suru)	heating
男性	だんせい	n.	man; male
できるだけ		adv.	as much as possible
電報	でんぽう	n.	telegram
電灯	でんとう	n.	electric light
どんどん		adv.	rapidly; more and more
泥棒	どろぼう	n.	thief
動物園	どうぶつえん	n.	zoo; zoological gardens
道具	どうぐ	n.	tool
枝	えだ	n.	branch
遠慮	えんりょ	n.(suru)	reserve; refraining
選ぶ	えらぶ	v.(u. t.)	to choose
エスカレーター		n.(kat.)	escalator
ファックス		n.(suru kat.)	fax
不便	ふべん	n.(na-adj.)	inconvenience
増える	ふえる	v.(ru. i.)	to increase
深い	ふかい	adj.(i-adj.)	deep
復習	ふくしゅう	n.(suru)	review (of learned material); revision
複雑	ふくざつ	n.(na-adj.)	complexity; complication
踏む	ふむ	v.(u. t.)	to step on
船	ふね	n.	ship
降り出す	ふりだす	v.(u. i.)	to start to rain
布団	ふとん	n.	Japanese bedding, futon
太る	ふとる	v.(u. i.)	to become fat
普通	ふつう	n.	usually
ガラス		n.(kat.)	a glass
ガソリン		n.(kat.)	gasoline; petrol
ガソリンスタンド		n.(kat.)	petrol station
ガス		n.(kat.)	petrol
原因	げんいん	n.(suru)	cause
下宿	げしゅく	n.(suru)	lodging
技術	ぎじゅつ	n.	art,technology,skill
ごちそう		n.(suru)	a feast
ごみ		n.	rubbish
ご覧になる	ごらんになる	v.(u.)	(respectful) to see
ご主人	ごしゅじん	n.	your husband; her husband
ご存じ	ごぞんじ	n.	knowing
具合	ぐあい	n.	condition; health
葉	は	n.	leaves; leaf
拝見	はいけん	n.(suru)	seeing; looking at​
歯医者	はいしゃ	n.	dentist
はっきり		adv.	clearly
運ぶ	はこぶ	v.(u. t.)	to carry
花見	はなみ	n.(suru)	cherry blossom viewing; flower viewing
ハンドバッグ		n.(kat.)	handbag
反対	はんたい	n.(na-adj. suru)	opposition
払う	はらう	v.(u. t.)	to pay
発音	はつおん	n.(suru)	pronunciation
林	はやし	n.	woods; forest
恥ずかしい	はずかしい	adj.(i-adj.)	embarrassed
変	へん	n.(na-adj.)	strange; peculiar; weird
返事	へんじ	n.(suru)	reply; answer; response
火	ひ	n.	fire
酷い	ひどい	adj.(i-adj.)	terrible; awful​
冷える	ひえる	v.(ru. i.)	to grow cold
髭	ひげ	n.	beard
非常に	ひじょうに	adv.	extremely
光	ひかり	n.	light
光る	ひかる	v.(u. i.)	to shine
引き出し	ひきだし	n.	drawer
引き出す	ひきだす	v.(u. t.)	to withdraw
引っ越す	ひっこす	v.(u. i.)	to move house
飛行場	ひこうじょう	n.	airfield; airport
開く	ひらく	v.(u. i. t.)	to open; to undo; to unseal; to unpack
拾う	ひろう	v.(u. t.)	to pick up
昼間	ひるま	n.	daytime; during the day
昼休み	ひるやすみ	n.	lunch break; noon recess; noon rest period
久しぶり	ひさしぶり	n.(na-adj.)	after a long time
褒める	ほめる	v.(ru. t.)	to praise
翻訳	ほんやく	n.(suru)	translation
星	ほし	n.	star
ほとんど		Adverbial Noun	mostly
法律	ほうりつ	n.	law
放送	ほうそう	n.(suru)	to broadcast
一度	いちど	n.	once; one time; on one occasion
以外	いがい	n.	with the exception of; excepting
医学	いがく	n.	medical science; medicine
いじめる		v.(ru. t.)	to tease
以上	いじょう	n.	... and more; ... and upwards​
以下	いか	n.	not exceeding
意見	いけん	n.(suru)	opinion; view; comment
生き物	いきもの	n.	living thing
生きる	いきる	v.(ru. i.)	to live
以内	いない	n.	within
田舎	いなか	n.	countryside
祈る	いのる	v.(u. t.)	to pray
いっぱい		n.(na-adj.)	full
色んな	いろんな	pren.	various
石	いし	n.	stone
急ぐ	いそぐ	v.(u. i.)	to hurry; to rush; to hasten; to make something happen sooner
一生懸命	いっしょうけんめい	n.(na-adj.)	very hard; with utmost effort
頂く	いただく	v.(u. t.)	(humble) to receive
致す	いたす	v.(u. t.)	(humble) to do
糸	いと	n.	thread
ジャム		n.(kat.)	jam
字	じ	n.	character
時代	じだい	n.	period
事故	じこ	n.	accident
事務所	じむしょ	n.	office
神社	じんじゃ	n.	Shinto shrine
人口	じんこう	n.	population
人生	じんせい	n.	human life
地震	じしん	n.	earthquake
辞典	じてん	n.	dictionary
自由	じゆう	n.(na-adj.)	freedom
女性	じょせい	n.	woman; female
準備	じゅんび	n.(suru)	to prepare
十分	じゅうぶん	n.(na-adj.)	enough; sufficient; plenty; adequate; satisfactory
柔道	じゅうどう	n.	judo
住所	じゅうしょ	n.	address
カーテン		n.(kat.)	curtain
壁	かべ	n.	wall
課長	かちょう	n.	section manager; section chief
帰り	かえり	n.	return; coming back
変える	かえる	v.(ru. t.)	to change; to transform
科学	かがく	n.	science
鏡	かがみ	n.	mirror
海岸	かいがん	n.	coast
会議	かいぎ	n.(suru)	meeting; conference; session; assembly
会議室	かいぎしつ	n.	conference room; conference hall; council room
会場	かいじょう	n.	assembly hall; meeting place; venue; grounds
会話	かいわ	n.(suru)	conversation
火事	かじ	n.	fire
格好	かっこう	n.	appearance
構う	かまう	v.(u.)	to mind
髪	かみ	n.	hair
噛む	かむ	v.(u. t.)	to bite,to chew
家内	かない	n.	(my) wife; inside the home; one's family
必ず	かならず	adv.	always; certainly
悲しい	かなしい	adj.(i-adj.)	sad
考える	かんがえる	v.(ru. t.)	to think
看護婦	かんごふ	n.	female nurse
関係	かんけい	n.(suru)	relationship
彼女	かのじょ	pron.	she; her​
簡単	かんたん	n.(na-adj.)	simple; easy
彼	かれ	pron.	he; him​; his
彼ら	かれら	pron.	they; them
形	かたち	n.	shape
片付ける	かたづける	v.(ru. t.)	to tidy up
硬い	かたい	adj.(i-adj.)	hard
勝つ	かつ	v.(u. i.)	to win
乾く	かわく	v.(u. i.)	to get dry
代わり	かわり	n.	instead; in place
変わる	かわる	v.(u. i.)	to change
通う	かよう	v.(u. i.)	to commute
飾る	かざる	v.(u. t.)	to decorate
毛	け	n.	hair or fur
ケーキ		n.(kat.)	cake
怪我	けが	n.(suru)	to injure
計画	けいかく	n.(suru)	to plan
経験	けいけん	n.(suru)	to experience
警察	けいさつ	n.	police
経済	けいざい	n.	finance, economy
見物	けんぶつ	n.(suru)	sightseeing; visit
喧嘩	けんか	n.(suru)	to quarrel
研究	けんきゅう	n.(suru)	research
研究室	けんきゅうしつ	n.	laboratory
消しゴム		n.	eraser
景色	けしき	n.	scenery
気	き	n.	spirit
厳しい	きびしい	adj.(i-adj.)	strict
気分	きぶん	n.	feeling; mood
機会	きかい	n.	chance; opportunity
危険	きけん	n.(na-adj.)	danger
聞こえる	きこえる	v.(ru. i.)	to be heard; to be audible; to be said
決まる	きまる	v.(u. i.)	to be decided
決める	きめる	v.(ru. t.)	to decide
君	きみ	pron.	You
気持ち	きもち	n.	feeling
着物	きもの	n.	kimono; Japanese traditional clothing
近所	きんじょ	n.	neighbourhood
絹	きぬ	n.	silk
季節	きせつ	n.	season
汽車	きしゃ	n.	train
規則	きそく	n.	rule
子	こ	n.	child
心	こころ	n.	heart
国際	こくさい	n.	international
細かい	こまかい	adj.(i-adj.)	small, fine
米	こめ	n.	(husked grains of) rice
込む	こむ	v.(u. i.)	to be crowded
今度	こんど	n.	this time; next time
この間	このあいだ	Adverbial Noun	the other day; recently
このごろ		Adverbial Noun	these days; nowadays
コンピュータ		n.(kat.)	computer
コンサート		n.(kat.)	concert
今夜	こんや	n.	this evening; tonigh
これから		conj.	after this
故障	こしょう	n.(suru)	to break-down
答え	こたえ	n.	response
小鳥	ことり	n.	small bird
こう		adv.	this way
校長	こうちょう	n.	principal; headmaster
講堂	こうどう	n.	auditorium
郊外	こうがい	n.	suburb; residential area on the outskirt of a city
講義	こうぎ	n.(suru)	lecture
工業	こうぎょう	n.	industry
工場	こうじょう	n.	factory
高校	こうこう	n.	senior high school; high school​
高校生	こうこうせい	n.	high school student
公務員	こうむいん	n.	government worker
高等学校	こうとうがっこう	n.	high school
交通	こうつう	n.	traffic
怖い	こわい	adj.(i-adj.)	frightening
壊れる	こわれる	v.(ru. i.)	to be broken
壊す	こわす	v.(u. t.)	to break
首	くび	n.	neck
下さる	くださる	v.(u.)	(respectful) to give
雲	くも	n.	cloud
君	くん	suf.	suffix for familiar young male
比べる	くらべる	v.(ru. t.)	to compare
暮れる	くれる	v.(ru. i.)	to get dark
草	くさ	n.	grass
空気	くうき	n.	air
空港	くうこう	n.	airport
客	きゃく	n.	guest; customer
教育	きょういく	n.(suru)	education
教会	きょうかい	n.	church; congregation; Christian church
興味	きょうみ	n.	interest (in something); curiosity (about something); zest (for)
競争	きょうそう	n.(suru)	competition
急	きゅう	adj.(na-adj.)	sudden; abrupt; unexpected
急行	きゅうこう	n.(suru)	hurrying (to somewhere); rushing; hastening
間違える	まちがえる	v.(ru. t.)	to make a mistake (in)
参る	まいる	v.(u. i.)	(humble) to go; to come
負ける	まける	v.(ru. i.)	to lose
漫画	まんが	n.	comic
間に合う	まにあう	v.(u. i.)	to be in time (for)
真ん中	まんなか	n.	middle; centre; center
周り	まわり	n.	around
回る	まわる	v.(u. i.)	to go around
まず		adv.	first of all
召し上がる	めしあがる	v.(u. t.)	to eat; to drink​
珍しい	めずらしい	adj.(i-adj.)	unusual; rare
見える	みえる	v.(ru. i.)	to be seen; to be in sight; to look; to seem
港	みなと	n.	harbour
味噌	みそ	n.	fermented condiment made from soybeans
見つかる	みつかる	v.(u. i.)	to be found; to be discovered
見つける	みつける	v.(ru. t.)	to discover; to find; to come across; to detect; to spot
都	みやこ	n.	capital
湖	みずうみ	n.	lake
戻る	もどる	v.(u. i.)	to turn back
木綿	もめん	n.	cotton (material)
森	もり	n.	forest
もし		adv.	if; in case; supposing
申し上げる	もうしあげる	v.(ru. t.)	to say; to offer
申す	もうす	v.(u. t.)	to be called; to say
もうすぐ		adv.	soon
迎える	むかえる	v.(ru. t.)	to go out to meet
昔	むかし	n.	olden days, former
向かう	むかう	v.(u. i.)	to head towards
無理	むり	n.(na-adj. suru)	impossible
虫	むし	n.	insect
息子	むすこ	n.	son
娘	むすめ	n.	daughter
投げる	なげる	v.(ru. t.)	to throw or cast away
泣く	なく	v.(u.)	to weep
無くなる	なくなる	v.(u. i.)	to disappear; to get lost
亡くなる	なくなる	v.(u. i.)	to die
生	なま	n.	raw
直る	なおる	v.(u. i.)	to be fixed,to be repaired
治る	なおる	v.(u. i.)	to be cured; to heal
慣れる	なれる	v.(ru. i.)	to get used to
鳴る	なる	v.(u. i.)	to sound
なるほど		adv.	now I understand
寝坊	ねぼう	n.(suru)	sleeping in late; oversleeping
値段	ねだん	n.	price; cost
眠い	ねむい	adj.(i-adj.)	sleepy
眠る	ねむる	v.(u. i.)	to sleep
熱	ねつ	n.	fever
苦い	にがい	adj.(i-adj.)	bitter
逃げる	にげる	v.(ru. i.)	to escape
二階建て	にかいだて	n.	two-storied building
人形	にんぎょう	n.	doll
匂い	におい	n.	a smell
似る	にる	v.(ru. i.)	to be similar
喉	のど	n.	throat
残る	のこる	v.(u. i.)	to remain
乗り換える	のりかえる	v.(ru. t.)	to change between buses or trains
乗り物	のりもの	n.	vehicle
濡れる	ぬれる	v.(ru. i.)	to get wet
塗る	ぬる	v.(u. t.)	to paint; to plaster
盗む	ぬすむ	v.(u. t.)	to steal
入学	にゅうがく	n.(suru)	entry to school or university; enrollment
入院	にゅういん	n.(suru)	hospitalization
落ちる	おちる	v.(ru. i.)	to fall or drop
踊り	おどり	n.	a dance
驚く	おどろく	v.(u. i.)	to be surprised
踊る	おどる	v.(u. i.)	to dance
お出でになる	おいでになる	v.(u.)	(respectful) to be
お祝い	おいわい	n.(suru)	congratulation
お嬢さん	おじょうさん	n.	(another's) daughter
可笑しい	おかしい	adj.(i-adj.)	strange or funny
行う	おこなう	v.(u. t.)	to perform; to do; to carry out
怒る	おこる	v.(u. i.)	to be angry
起こす	おこす	v.(u. t.)	to wake
億	おく	num.	one hundred million
屋上	おくじょう	n.	rooftop​
遅れる	おくれる	v.(ru. i.)	to be late
贈り物	おくりもの	n.	present; gift
送る	おくる	v.(u. t.)	to send
お祭り	おまつり	n.	festival
お見舞い	おみまい	n.	visiting ill or distressed people
お土産	おみやげ	n.	souvenir
おもちゃ		n.	toy
思い出す	おもいだす	v.(u. t.)	to remember
表	おもて	n.	the front
オートバイ		n.(kat.)	motorcycle
お礼	おれい	n.	thanks
折れる	おれる	v.(ru. i.)	to break; to be broken
下りる	おりる	v.(ru. i.)	to get off
折る	おる	v.(u. t.)	to break or to fold
押し入れ	おしいれ	n.	closet
仰る	おっしゃる	v.(u. t.)	(respectful) to say
お宅	おたく	n.	your home
音	おと	n.	sound; note
落とす	おとす	v.(u. t.)	to drop
お釣り	おつり	n.	change (for a purchase)​
夫	おっと	n.	husband
終わり	おわり	n.	the end
親	おや	n.	parents
泳ぎ方	およぎかた	n.	way of swimming
パート		n.(kat.)	part; part time
パソコン		n.(kat.)	personal computer
ピアノ		n.(kat.)	piano
プレゼント		n.(kat.)	present; gift
冷房	れいぼう	n.(suru)	air conditioning
レジ		n.(kat.)	cashier​
歴史	れきし	n.	history
連絡	れんらく	suru	to contact; to get in touch​
レポート		n.(kat.)	report
利用	りよう	n.(suru)	use; utilization; application
理由	りゆう	n.	reason
留守	るす	n.(suru)	absence
旅館	りょかん	n.	traditional inn; Japanese-style lodging
両方	りょうほう	n.	both sides
寂しい	さびしい	adj.(i-adj.)	lonely
下がる	さがる	v.(u. i.)	to get down
探す	さがす	v.(u. t.)	to look for
下げる	さげる	v.(ru. t.)	to lower
最後	さいご	n.	end; last
最近	さいきん	n.	recently
最初	さいしょ	n.	beginning; first
坂	さか	n.	slope; hill
盛ん	さかん	adj.(na-adj.)	popularity; prosperous
昨夜	さくや	n.	last night
サンダル		n.(kat.)	sandal
サンドイッチ		n.(kat.)	sandwich
産業	さんぎょう	n.	industry
サラダ		n.(kat.)	salad
再来月	さらいげつ	n.	month after next
再来週	さらいしゅう	n.	week after next
差し上げる	さしあげる	v.(ru. t.)	to give
騒ぐ	さわぐ	v.(u. i.)	to make noise,to be excited
触る	さわる	v.(u. i.)	to touch
生物	せいぶつ	n.	living thing
政治	せいじ	n.	politics
生活	せいかつ	n.(suru)	to live
生命	せいめい	n.	life
生産	せいさん	n.(suru)	production
西洋	せいよう	n.	the west; Western countries
世界	せかい	n.	the world
席	せき	n.	seat
線	せん	n.	line
背中	せなか	n.	back (of body)
先輩	せんぱい	n.	senior
戦争	せんそう	n.(suru)	war
説明	せつめい	n.(suru)	explanation
社長	しゃちょう	n.	company president; manager; director
社会	しゃかい	n.	society; public; community; the world
市	し	n.	city
試合	しあい	n.(suru)	match,game
叱る	しかる	v.(u. t.)	to scold
仕方	しかた	n.	way; method
試験	しけん	n.(suru)	examination
しっかり		adv.(suru)	firmly; steadily
島	しま	n.	island
市民	市民	n.	citizen
品物	しなもの	n.	goods; article; thing
新聞社	しんぶんしゃ	n.	newspaper company
親切	しんせつ	n.(na-adj.)	kindness
失敗	しっぱい	n.(suru)	failure
調べる	しらべる	v.(ru. t.)	to investigate
知らせる	しらせる	v.(ru. t.)	to notify
下着	したぎ	n.	underwear
食料品	しょくりょうひん	n.	food; groceries
小学校	しょうがっこう	n.	elementary school
生じる	しょうじる	v.(ru. t.)	to produce
紹介	しょうかい	n.(suru)	introduction
将来	しょうらい	n.	future
小説	しょうせつ	n.	novel
趣味	しゅみ	n.	hobby; pastime; preference
習慣	しゅうかん	n.	habit; custom; cultural practice.
祖母	そぼ	n.	grandmother
育てる	そだてる	v.(ru. t.)	to rear,to bring up
祖父	そふ	n.	grandfather
ソフト		n.(kat.)	soft
そんな		pren.	that sort of
それで		conj.	because of that
それほど		adv.	to that extent
そろそろ		adv.	gradually; soon
卒業	そつぎょう	n.(suru)	graduation
相談	そうだん	n.(suru)	to discuss
素晴らしい	すばらしい	adj.(i-adj.)	wonderful
滑る	すべる	v.(u. i.)	to slide; to slip
凄い	すごい	adj.(i-adj.)	terrific
水道	すいどう	n.	water supply
水泳	すいえい	n.(suru)	swimming
すっかり		adv.	completely
空く	すく	v.(u. i.)	to be hungry
スクリーン		n.(kat.)	screen
隅	すみ	n.	corner; nook
済む	すむ	v.(u. i.)	to finish
砂	すな	n.	sand
すり		n.	pickpocket
スーツケース		n.(kat.)	suitcase
進む	すすむ	v.(u. i.)	to make progress
ステーキ		n.(kat.)	steak
ステレオ		n.(kat.)	stereo
捨てる	すてる	v.(ru. t.)	to throw away
数学	すうがく	n.	mathematics; arithmetic
スーツ		n.(kat.)	suit
正しい	ただしい	adj.(i-adj.)	right; correct
退院	たいいん	n.(suru)	leaving hospital; discharge from hospital
台風	たいふう	n.	typhoon
タイプ		n.	type,style
たいてい		n.(na-adj.)	usually
たまに		adv.	occasionally
棚	たな	n.	shelves
誕生	たんじょう	n.(suru)	birth
楽しみ	たのしみ	n.(na-adj.)	looking forward to​
倒れる	たおれる	v.(ru. i.)	to fall (over, down)
足りる	たりる	v.(ru. i.)	to be sufficient; to be enough
足す	たす	v.(u. t.)	to add (numbers / something)
畳	たたみ	n.	Japanese straw mat
建てる	たてる	v.(ru. t.)	to build
尋ねる	たずねる	v.(ru. t.)	to ask
訪ねる	たずねる	v.(ru. t.)	to visit
手袋	てぶくろ	n.	glove
丁寧	ていねい	n.(na-adj.)	polite
テキスト		n.(kat.)	text; textbook
適当	てきとう	n.(na-adj.)	suitable
点	てん	n.	point; dot
店員	てんいん	n.	employee (of a store); shop assistant; clerk
テニス		n.(kat.)	tennis
天気予報	てんきよほう	n.	weather forecast
展覧会	てんらんかい	n.	exhibition
寺	てら	n.	temple
手伝う	てつだう	v.(u. t.)	to help; to assist; to aid​
途中	とちゅう	n.	on the way
届ける	とどける	v.(ru. t.)	to send​
特急	とっきゅう	n.	limited express (train, faster than an express)
床屋	とこや	n.	barber
特別	とくべつ	n.(na-adj.)	special; particular; extraordinary; exceptional
特に	とくに	adv.	particularly; especially; in particular; expressly
泊まる	とまる	v.(u. i.)	to stay at
止める	とめる	v.(ru. t.)	to stop something
遠く	とおく	n.	distant
通る	とおる	v.(u. i.)	to go through
取り替える	とりかえる	v.(ru. t.)	to exchange; to swap; to replace
到頭	とうとう	adv.	finally, after all
続ける	つづける	v.(ru. t.)	to continue; to keep up; to keep on
続く	つづく	v.(u. i.)	to continue
都合	つごう	n.	convenience
捕まえる	つかまえる	v.(ru. t.)	to catch
漬ける	つける	v.(ru. t.)	to soak; to pickle
月	つき	n.	moon
付く	つく	v.(u. i.)	to be attached
妻	つま	n.	(humble) wife
連れる	つれる	v.(ru. t.)	to take (someone) with one
釣る	つる	v.(u. t.)	to fish
伝える	つたえる	v.(ru. t.)	to report; to tell
包む	つつむ	v.(u. t.)	to wrap
腕	うで	n.	arm
植える	うえる	v.(ru. t.)	to plant; to grow
動く	うごく	v.(u. i.)	to move
伺う	うかがう	v.(u. t.)	to visit
受ける	うける	v.(ru. t.)	to take a lesson or test
受付	うけつけ	n.	reception (desk); information desk​
生まれ	うまれ	n.	birth
運転手	うんてんしゅ	n.	driver; chauffeur
裏	うら	n.	reverse side
嬉しい	うれしい	adj.(i-adj.)	happy
売り場	うりば	n.	selling area
嘘	うそ	n.	a lie
打つ	うつ	v.(u. t.)	to hit
美しい	うつくしい	adj.(i-adj.)	beautiful
移る	うつる	v.(u. i.)	to move house or transfer
写す	うつす	v.(u. t.)	to copy or photograph
ワープロ		n.(kat.)	word processor
別れる	わかれる	v.(ru. i.)	to separate
沸かす	わかす	v.(u. t.)	to boil; to heat
沸く	わく	v.(u. i.)	to boil
笑う	わらう	v.(u. i.)	to laugh; to smile
割れる	われる	v.(ru. i.)	to break
割合	わりあい	n.	rate; ratio
忘れ物	わすれもの	n.	lost article
焼ける	やける	v.(ru. i.)	to burn; to be roasted
焼く	やく	v.(u. t.)	to bake; to grill
役に立つ	やくにたつ	v.(u.)	to be helpful
約束	やくそく	n.(suru)	promise
止む	やむ	v.(u. i.)	to stop
やっぱり		adv.	as I thought
優しい	やさしい	adj.(i-adj.)	kind
痩せる	やせる	v.(ru. i.)	to become thin
柔らかい	やわらかい	adj.(i-adj.)	soft
汚れる	よごれる	v.(ru. i.)	to get dirty
喜ぶ	よろこぶ	v.(u.)	to be delighted
寄る	よる	v.(u. i.)	to visit; to drop by
予習	よしゅう	n.(suru)	preparation for a lesson
予定	よてい	n.(suru)	plan
用	よう	n.	business; task; errand; use; purpose
用意	ようい	n.(suru)	preparation; arrangements; provision; getting ready
用事	ようじ	n.	tasks; things to do; errand; business (to take care of)
予約	よやく	n.(suru)	reservation
湯	ゆ	n.	hot water
指	ゆび	n.	finger
指輪	ゆびわ	n.	finger ring
夢	ゆめ	n.	dream
揺れる	ゆれる	v.(ru. i.)	to shake
残念	ざんねん	n.(na-adj.)	regrettable; unfortunate
全然	ぜんぜん	adv.	not entirely (used in a negative sentence)
