浴びる	あびる	v.(ru. t.)	to bathe, to shower
危ない	あぶない	adj.(i-adj.)	dangerous
あっち		pron.	over there
あちら		pron.	there
上げる	あげる	v.(ru. t.)	to raise; to elevate; to give
赤	あか	n.	red; crimson; scarlet​
赤い	あかい	adj.(i-adj.)	red; crimson; scarlet​
明るい	あかるい	adj.(i-adj.)	bright; light
開ける	あける	v.(ru. t.)	to open (a door, etc.); to unwrap (e.g. parcel, package); to unlock
秋	あき	n.	autumn; fall
開く	あく	v.(u. i.)	to open (e.g. doors, business, etc)
甘い	あまい	adj.(i-adj.)	sweet; sweet-tasting; sugary; naive; indulgent
雨	あめ	n.	rain
飴	あめ	n.	candy
あなた		pron.	you
姉	あね	n.	older sister; elder sister​
兄	あに	n.	elder brother; older brother​
あの		pren.	that
青	あお	n.	blue; azure
青い	あおい	adj.(i-adj.)	blue; azure
アパート		n.(kat.)	apartment
洗う	あらう	v.(u. t.)	to wash
あれ		pron.	that
ある		v.(u. i.)	to be, to have
歩く	あるく	v.(u. i.)	to walk
朝	あさ	n.	morning
朝ご飯	あさごはん	n.	breakfast
明後日	あさって	n.	day after tomorrow
足	あし	n.	foot; leg; paw; arm
明日	あした	n.(temp.)	tomorrow
遊ぶ	あそぶ	v.(u. i.)	to play; to enjoy oneself
あそこ		pron.	over there
頭	あたま	n.	head
新しい	あたらしい	adj.(i-adj.)	new; novel; fresh; recent; latest
暖かい	あたたかい	adj.(i-adj.)	warm
後	あと	n.	behind; after; remainder; left; also
暑い	あつい	adj.(i-adj.)	hot; sultry
厚い	あつい	adj.(i-adj.)	thick
熱い	あつい	adj.(i-adj.)	hot
会う	あう	v.(u. i.)	to meet; to encounter; to see
晩ご飯	ばんごはん	n.	dinner; evening meal
番号	ばんごう	n.	number
バス		n.(kat.)	bus
バター		n.(kat.)	butter​
ベッド		n.(kat.)	bed
勉強	べんきょう	n.(suru)	to study
便利	べんり	na-adj.	convenient; handy; useful
ボールペン		n.(kat.)	ball-point pen
ボタン		n.(kat.)	button
帽子	ぼうし	n.	hat; cap
文章	ぶんしょう	n.	sentence
豚肉	ぶたにく	n.	pork
病院	びょういん	n.	hospital
病気	びょうき	n.	illness; disease; sickness
茶色	ちゃいろ	n.	brown
茶碗	ちゃわん	n.	rice bowl; tea cup; teacup
父	ちち	n.	father
違う	ちがう	v.(u. i.)	to differ
小さい	ちいさい	adj.(i-adj.)	small; little; tiny
小さな	ちいさな	pren.	small; little; tiny​
近い	ちかい	i-adj.	near; close
地下鉄	ちかてつ	n.	subway; underground train
地図	ちず	n.	map
ちょっと		adv.	a little
丁度	ちょうど	adv.	exactly
台所	だいどころ	n.	kitchen
大学	だいがく	n.	university; college
大丈夫	だいじょうぶ	adj.(na-adj.)	OK; okay; alright; problem free
大好き	だいすき	adj.(na-adj.)	love; like; like very much
だんだん		adv.	gradually
誰	だれ	pron.	who
誰か	だれか	pron.	someone; somebody
出す	だす	v.(u. t.)	to take out; to get out; to put out; to reveal
出口	でぐち	n.	exit; gateway; way out
出かける	でかける	v.(ru. i.)	to go out; to leave; to depart
電気	でんき	n.	electricity
電車	でんしゃ	n.	train; electric train
電話	でんわ	n.(suru)	telephone (call / device)l; phone call
デパート		n.(kat.)	department store
出る	でる	v.(ru. i.)	to leave; to exit; to appear; to go out
ドア		n.(kat.)	door
どっち		pron.	which; which one
どちら		pron.	which of two
どこ		pron.	where; what place​
どなた		n.	who
どの		pren.	which
どれ		pron.	which (of three or more)​
どう		adv.	how; in what way; how about​
動物	どうぶつ	n.	animal
どうも		adv.	thank you; thanks
どうぞ		adv.	please
土曜日	どようび	n.	Saturday
絵	え	n.	picture
ええ		n.	yes; that is correct; right
映画	えいが	n.	movie; film
映画館	えいがかん	n.	movie theater; cinema
英語	えいご	n.	English language
駅	えき	n.	station
鉛筆	えんぴつ	n.	pencil
エレベーター		n.(kat.)	elevator
フィルム		n.(kat.)	film
フォーク		n.(kat.)	fork
服	ふく	n.	clothes
吹く	ふく	v.(u. i.)	to blow (of the wind)
降る	ふる	v.(u. i.)	to fall
古い	ふるい	i-adj.	old (not used for people)
二人	ふたり	n.	two people; pair; couple
二つ	ふたつ	n.	two; 2
太い	ふとい	adj.(i-adj.)	fat; thick
二日	ふつか	n.	the second day of the month / 2 days
封筒	ふうとう	n.	envelope
冬	ふゆ	n.	winter
外国	がいこく	n.	foreign country
外国人	がいこくじん	n.	foreigner; foreign citizen; foreign national; alien; non-Japanese
学校	がっこう	n.	school
学生	がくせい	n.	student
玄関	げんかん	n.	entrance
元気	げんき	n.(na-adj.)	lively; full of spirit; energetic; healthy
月曜日	げつようび	n.	Monday
銀行	ぎんこう	n.	bank
ギター		n.(kat.)	guitar
五	ご	n.	five; 5
午後	ごご	n.	afternoon; p.m.
ご飯	ごはん	n.	cooked rice, meal
午前	ごぜん	n.	morning; a.m.
グラム		n.(kat.)	gram
牛肉	ぎゅうにく	n.	beef
牛乳	ぎゅうにゅう	n.	(cow's) milk
歯	は	n.	tooth
八	はち	n.	eight: 8
葉書	はがき	n.	postcard
母	はは	n.	mother
はい		n.	yes; that is correct​
入る	はいる	v.(u. i.)	to enter; to go into
灰皿	はいざら	n.	ashtray
始まる	はじまる	v.(u. i.)	to begin
初めて	はじめて	adv.	for the first time
箱	はこ	n.	box; crate
履く	はく	v.(u. t.)	to wear, to put on trousers
半	はん	n.	half; semi-; half-past
花	はな	n.	flower
鼻	はな	n.	nose
話	はなし	n.	talk; speech; chat; conversation​
話す	はなす	v.(u. t.)	to speak; to talk; to converse
半分	はんぶん	n.	half
ハンカチ		n.(kat.)	handkerchief​
晴れ	はれ	n.	clear weather
晴れる	はれる	v.(ru. i.)	to be sunny
春	はる	n.	spring; springtime
貼る	はる	v.(u. t.)	to stick; to paste
箸	はし	n.	chopsticks
橋	はし	n.	bridge
走る	はしる	v.(u. i.)	to run
二十歳	はたち	n.	20 years old; twenty years old
働く	はたらく	v.(u. i.)	to work
二十日	はつか	n.	twentieth day of the month / 20 days
速い	はやい	adj.(i-adj.)	fast; quick; hasty; brisk
早い	はやい	adj.(i-adj.)	fast; early
辺	へん	n.	area
下手	へた	n.(na-adj.)	unskillful; poor; awkward​
部屋	へや	n.	room
左	ひだり	n.	left; left hand side
東	ひがし	n.	east
飛行機	ひこうき	n.	airplane; aircraft
引く	ひく	v.(u. t.)	to pull
弾く	ひく	v.(u. t.)	to play
低い	ひくい	i-adj.	short,low
暇	ひま	n.(na-adj.)	free time
広い	ひろい	i-adj.	spacious; vast; wide
昼	ひる	n.	noon; midday; daytime; lunch
昼ご飯	ひるごはん	n.	lunch
人	ひと	n.	person; human
一人	ひとり	n.	one person​; alone; single
一つ	ひとつ	n.	one thing; only
ほか		n.	other (place, thing, person); the rest
本	ほん	n.	book; volume; script
本棚	ほんだな	n.	bookshelf; bookcase
本当	ほんとう	n.(na-adj.)	truth; reality; actuality; fact
欲しい	ほしい	adj.(i-adj.)	want
細い	ほそい	adj.(i-adj.)	thin; slender
ホテル		n.(kat.)	hotel
百	ひゃく	n.	100; hundred
一	いち	n.	one; best; first; foremost; start
一番	いちばん	n.	number one; first; 1st, first place​; best; most​
一日	いちにち	n.	one day, all day
家	いえ	n.	house, residence, family
いかが		adv.	how; in what way; how about​
池	いけ	n.	pond
行く	いく	v.(u. i.)	to go; to move
いくら		n.	how much?; how many?​
いくつ		adv.	how many?,how old?
今	いま	n.	now; the present time; soon
意味	いみ	n.	meaning; significance; sense
妹	いもうと	n.	younger sister
犬	いぬ	n.	dog
入れる	いれる	v.(ru. t.)	to put in; to let in; to take in; to bring in; to insert; to install
入口	いりぐち	n.	entrance; entry; gate
色	いろ	n.	colour; color
色々	いろいろ	n.(na-adj.)	various
要る	いる	v.(u. i.)	to be needed
居る	いる	v.(ru. i.)	to be, to have
医者	いしゃ	n.	(medical) doctor; physician
忙しい	いそがしい	adj.(i-adj.)	busy
一緒	いっしょ	n.	together; at the same time; same; identical
椅子	いす	n.	chair
痛い	いたい	adj.(i-adj.)	painful; sore​
いつ		pron.	when
五日	いつか	n.	the fifth day of the month / 5 days
五つ	いつつ	n.	five; 5
言う	いう	v.(u.)	to say; to call
嫌	いや	n.(na-adj.)	unpleasant
じゃあ		conj.	then; well; so; well then
字引	じびき	n.	dictionary
自分	じぶん	pron.	myself; yourself; oneself; himself; herself; i; me
自動車	じどうしゃ	n.	automobile; motorcar; motor vehicle; car
時間	じかん	n.	time; hour(s)
辞書	じしょ	n.	dictionary
自転車	じてんしゃ	n.	bicycle
丈夫	じょうぶ	adj.(na-adj.)	strong, durable
上手	じょうず	n.(na-adj.)	skillful; skilled; proficient; good (at)
授業	じゅぎょう	n.(suru)	lesson; class work
十	じゅう	n.	ten; 10
かばん		n.	bag; basket​
花瓶	かびん	n.	a vase
角	かど	n.	a corner; angle​
帰る	かえる	v.(u. i.)	to go back​
返す	かえす	v.(u. t.)	to return something
鍵	かぎ	n.	key
階段	かいだん	n.	stairs; stairway; staircase
買い物	かいもの	n.	shopping; purchased goods
会社	かいしゃ	n.	company; corporation
掛かる	かかる	v.(u. i.)	to take (a resource, e.g. time or money)
掛ける	かける	v.(ru. t.)	to hang up; to make (a call)​;
書く	かく	v.(u. t.)	to write; to compose; to pen; to draw
カメラ		n.(kat.)	camera
紙	かみ	n.	paper
漢字	かんじ	n.	kanji
カップ		n.(kat.)	cup
体	からだ	n.	body
辛い	からい	i-adj.	spicy
カレー		n.(kat.)	curry
カレンダー		n.(kat.)	calendar
借りる	かりる	v.(ru. t.)	to borrow
軽い	かるい	adj.(i-adj.)	light
傘	かさ	n.	umbrella
貸す	かす	v.(u. t.)	to lend; to loan
方	かた	n.	way of doing something
家庭	かてい	n.	household
買う	かう	v.(u. t.)	to buy; to purchase
川	かわ	n.	river; stream​
可愛い	かわいい	adj.(i-adj.)	cute
火曜日	かようび	n.	Tuesday
風	かぜ	n.	wind
風邪	かぜ	n.	a cold
家族	かぞく	n.	family; members of a family
警官	けいかん	n.	policeman; police officer
結婚	けっこん	n.(suru)	marriage
結構	けっこう	n.(na-adj.)	splendid, enough
今朝	けさ	n.(temp.)	this morning
消す	けす	v.(u. t.)	to erase, to turn off power
木	き	n.	tree; shrub; bush; wood; timber
消える	きえる	v.(ru. i.)	to disappear
黄色い	きいろい	adj.(i-adj.)	yellow
聞く	きく	v.(u. t.)	to hear; to listen (to music); to ask; to learn of
昨日	きのう	n.	yesterday
金曜日	きんようび	n.	Friday
切符	きっぷ	n.	ticket
嫌い	きらい	n.(na-adj.)	hate
綺麗	きれい	adj.(na-adj.)	pretty; lovely; beautiful
キログラム		n.(kat.)	kilogram
キロメートル		n.(kat.)	kilometer
切る	きる	v.(u. t.)	to cut
着る	きる	v.(ru. t.)	to wear
喫茶店	きっさてん	n.	coffee shop; tearoom; cafe
北	きた	n.	north
汚い	きたない	adj.(i-adj.)	dirty
切手	きって	n.	stamp (postage)
こっち		n.	this person or way
こちら		n.	this way; this direction​
子供	こども	n.	child
声	こえ	n.	voice
ここ		pron.	here; this place
九日	ここのか	n.	ninth day of the month / 9 days
九つ	ここのつ	n.	nine; 9
困る	こまる	v.(u. i.)	to be troubled
今晩	こんばん	n.	tonight; this evening
今月	こんげつ	n.	this month
こんな		pren.	such; like this​
この		pren.	this​
今週	こんしゅう	n.	this week
コーヒー		n.(kat.)	Coffee
コート		n.(kat.)	coat
コピー		n.(suru kat.)	copy; photocopy
コップ		n.(kat.)	glass (drinking vessel); tumbler​
これ		pron.	this
答える	こたえる	v.(ru. i.)	to answer
言葉	ことば	n.	word; words
今年	ことし	n.	this year
交番	こうばん	n.	police box
紅茶	こうちゃ	n.	black tea
公園	こうえん	n.	park
交差点	こうさてん	n.	intersection
口	くち	n.	mouth, opening
果物	くだもの	n.	fruit
下さい	ください	expr.	please
曇り	くもり	n.	cloudiness; cloudy weather
曇る	くもる	v.(u. i.)	to become cloudy, to become dim
国	くに	n.	country; state; region
暗い	くらい	adj.(i-adj.)	dark; gloomy; murky
クラス		n.(kat.)	class
黒	くろ	n.	black
黒い	くろい	i-adj.	black
来る	くる	v.(i.)	to come
車	くるま	n.	car; automobile; vehicle
薬	くすり	n.	medicine
靴	くつ	n.	shoes
靴下	くつした	n.	socks
去年	きょねん	n.	last year
今日	きょう	n.(temp.)	today; this day
兄弟	きょうだい	n.	siblings; brothers and sisters​; mate
教室	きょうしつ	n.	classroom
九	きゅう	n.	nine; 9
マッチ		n.(kat.)	match
町	まち	n.	town; block; neighborhood
窓	まど	n.	window
前	まえ	n.	previous; before; in front; ago
曲がる	まがる	v.(u. i.)	to turn, to bend
毎朝	まいあさ	n.	every morning
毎晩	まいばん	n.	every night
毎日	まいにち	n.	every day
毎週	まいしゅう	n.	every week
毎年	まいとし / まいねん	n.	every year; yearly; annually
毎月	まいつき	n.	every month; monthly
万	まん	n.	10,000; ten thousand
万年筆	まんねんひつ	n.	fountain pen
丸い	まるい	adj.(i-adj.)	round,circular
真っ直ぐ	まっすぐ	n.(na-adj.)	straight ahead,direct
待つ	まつ	v.(u. i. t.)	to wait​
不味い	まずい	adj.(i-adj.)	unpleasant
目	め	n.	eye
メートル		n.(kat.)	metre; meter
眼鏡	めがね	n.	glasses
道	みち	n.	road; street
緑	みどり	n.	green
磨く	みがく	v.(u. i.)	to polish; to shine; to brush (e.g. teeth)
右	みぎ	n.	right; right hand side
短い	みじかい	adj.(i-adj.)	short
三日	みっか	n.	the third day of the month / 3 days
耳	みみ	n.	ear; hearing
南	みなみ	n.	south
皆さん	みなさん	n.	everyone
みんな		n.	all; everyone; everybody
見る	みる	v.(ru. t.)	to see; to look; to watch; to view; to observe
店	みせ	n.	store; shop; establishment; restaurant
見せる	みせる	v.(ru. t.)	to show; to display
三つ	みっつ	n.	three; 3
水	みず	n.	water; fluid; liquid​
木曜日	もくようび	n.	Thursday
門	もん	n.	gate
問題	もんだい	n.	problem; question (e.g. on a test)
物	もの	n.	thing
持つ	もつ	v.(u.)	to hold
もっと		adv.	more; longer; further
もう一度	もういちど	expr.	once more; again
六日	むいか	n.	sixth day of the month / 6 days
向こう	むこう	n.	over there
村	むら	n.	village
六つ	むっつ	n.	six; 6
難しい	むずかしい	adj.(i-adj.)	difficult
長い	ながい	adj.(i-adj.)	long (distance)​; long (time); lengthy.
ナイフ		n.(kat.)	knife
中	なか	n.	inside; in; within; center
鳴く	なく	v.(u. i.)	animal noise. to chirp
無くす	なくす	v.(u. t.)	to lose (something)
名前	なまえ	n.	name; full name; given name
七つ	ななつ	n.	seven; 7
何	なに	n.	what
七日	なのか	n.	seventh day of the month / 7 days
並べる	ならべる	v.(ru. t.)	to line up,to set up
並ぶ	ならぶ	v.(u. i.)	to line up,to stand in a line
習う	ならう	v.(u. t.)	to be taught; to learn (from a teacher)
夏	なつ	n.	summer
夏休み	なつやすみ	n.	summer vacation; summer holiday
何故	なぜ	adv.	why; how
猫	ねこ	n.	cat
ネクタイ		n.(kat.)	tie; necktie
寝る	ねる	v.(ru. i.)	to sleep; to go to bed; to lie down
二	に	n.	two; 2
日曜日	にちようび	n.	Sunday
賑やか	にぎやか	adj.(na-adj.)	bustling,busy
日記	にっき	n.	diary; journal
肉	にく	n.	meat
荷物	にもつ	n.	luggage; baggage
西	にし	n.	west
庭	にわ	n.	garden
登る	のぼる	v.(u. i.)	to climb
飲み物	のみもの	n.	drink; beverage
飲む	のむ	v.(u. t.)	to drink
ノート		n.(kat.)	notebook
乗る	のる	v.(u. i.)	to get on (train, plane, bus, ship, etc.)
脱ぐ	ぬぐ	v.(u. t.)	to take off clothes
温い	ぬるい	adj.(i-adj.)	luke warm
ニュース		n.(kat.)	news
おばあさん		n.	grandmother
伯母さん	おばさん	n.	aunt; old lady
お弁当	おべんとう	n.	lunch box; Japanese box lunch
覚える	おぼえる	v.(ru. t.)	to remember
お茶	おちゃ	n.	tea
お風呂	おふろ	n.	bath
美味しい	おいしい	i-adj.	delicious
伯父さん	おじさん	n.	uncle; old man; mister
お母さん	おかあさん	n.	mother; mom; mum; ma
お金	おかね	n.	money
お菓子	おかし	n.	confections; sweets; candy
起きる	おきる	v.(ru. i.)	to get up; to wake up
置く	おく	v.(u. t.)	to put; to place​
奥さん	おくさん	n.	wife; your wife; his wife
お巡りさん	おまわりさん	n.	police officer (friendly term for policeman)
重い	おもい	i-adj.	heavy
面白い	おもしろい	adj.(i-adj.)	interesting
同じ	おなじ	n.	same
お腹	おなか	n.	stomach
お姉さん	おねえさん	n.	elder sister; young lady; miss; ma'am
音楽	おんがく	n.	music
お兄さん	おにいさん	n.	older brother; elder brother; young man; buddy
女	おんな	n.	woman; female sex
女の子	おんなのこ	n.	girl; daughter; young women
多い	おおい	adj.(i-adj.)	many; numerous; a lot; large quantity; frequent
大きい	おおきい	adj.(i-adj.)	big; large; great; important
大きな	おおきな	pren.	big; large; great​
大勢	おおぜい	n.	crowd of people; great number of people
降りる	おりる	v.(ru. i.)	to get off
お酒	おさけ	n.	alcohol
お皿	おさら	n.	plate, dish
教える	おしえる	v.(ru. t.)	to teach
遅い	おそい	adj.(i-adj.)	slow; time-consuming; late
押す	おす	v.(u. t.)	to push; to press​
お手洗い	おてあらい	n.	toilet; restroom; lavatory; bathroom
男	おとこ	n.	man; male
男の子	おとこのこ	n.	boy; male child; baby boy
大人	おとな	n.	adult
一昨日	おととい	n.	day before yesterday
一昨年	おととし	n.	year before last
お父さん	おとうさん	n.	father; dad; papa; pa; pop; daddy
弟	おとうと	n.	younger brother
終わる	おわる	v.(u. i.)	to finish; to end
泳ぐ	およぐ	v.(u. i.)	to swim
パーティー		n.(kat.)	party
パン		n.(kat.)	bread
ページ		n.(kat.)	page
ペン		n.(kat.)	pen
ペット		n.(kat.)	pet
ポケット		n.	pocket
ポスト		n.(kat.)	post
プール		n.(kat.)	swimming pool
来月	らいげつ	n.	next month
来年	らいねん	n.	next year
来週	らいしゅう	n.	next week
ラジオ		n.(kat.)	radio
零	れい	n.	zero
冷蔵庫	れいぞうこ	n.	refrigerator
レコード		n.(kat.)	record
練習	れんしゅう	n.(suru)	practice; practicing
レストラン		n.(kat.)	restaurant
立派	りっぱ	adj.(na-adj.)	splendid
六	ろく	n.	six; 6
廊下	ろうか	n.	corridor; hallway; passageway
旅行	りょこう	n.(suru)	travel; trip; journey; excursion; tour
料理	りょうり	n.(suru)	cuisine
両親	りょうしん	n.	parents; both parents
留学生	りゅうがくせい	n.	overseas student; exchange student
さあ		conj.	well…
財布	さいふ	n.	purse; wallet
魚	さかな	n.	fish
先	さき	n.	previous; prior; first; earlier
咲く	さく	v.(u. i.)	to bloom
作文	さくぶん	n.	writing; composition
寒い	さむい	adj.(i-adj.)	cold
三	さん	n.	three; 3
散歩	さんぽ	n.(suru)	walk; stroll
再来年	さらいねん	n.	year after next
差す	さす	v.(u. t.)	to stretch out hands, to raise an umbrella
砂糖	さとう	n.	sugar
背	せ	n.	height; stature; back; spine
背広	せびろ	n.	business suit
セーター		n.(kat.)	sweater; jumper
生徒	せいと	n.	pupil; student
石鹼	せっけん	n.	soap
狭い	せまい	i-adj.	narrow
千	せん	n.	1,000; thousand
先月	せんげつ	n.	last month
先生	せんせい	n.	teacher; instructor; master
先週	せんしゅう	n.	last week
洗濯	せんたく	n.(suru)	washing; laundry
写真	しゃしん	n.	photograph; photo
シャツ		n.(kat.)	shirt
シャワー		n.(kat.)	shower
四	し	n.	four; 4
七	しち	n.	seven; 7
仕事	しごと	n.(suru)	work; job; business
閉まる	しまる	v.(u. i.)	to close, to be closed
閉める	しめる	v.(ru. t.)	to close; to shut
締める	しめる	v.(ru. t.)	to tie; to fasten; to tighten​
新聞	しんぶん	n.	newspaper
死ぬ	しぬ	v.(u. i.)	to die
塩	しお	n.	salt
白	しろ	n.	white; innocence; innocent person
白い	しろい	adj.(i-adj.)	white
知る	しる	v.(u. t.)	to know
下	した	n.	below; down; under; bottom
質問	しつもん	n.(suru)	question; inquiry
静か	しずか	adj.(na-adj.)	quiet
食堂	しょくどう	n.	cafeteria; dining room
醬油	しょうゆ	n.	soy sauce
宿題	しゅくだい	n.	homework; assignment; pending issue
そば		n.	near; beside
そっち		pron.	that way; ​over there
そちら		pron.	that way (distant from speaker, close to listener); you; your family
そこ		pron.	that place​; there
その		pren.	that
空	そら	n.	sky; the air
それ		pron.	that
それでは		expr.	in that situation
外	そと	n.	outside; exterior;
掃除	そうじ	n.(suru)	to clean, to sweep
直ぐに	すぐに	adv.	immediately; right away; instantly​
水曜日	すいようび	n.	Wednesday
スカート		n.(kat.)	skirt
好き	すき	n.(na-adj.)	like
少し	すこし	n.	a little (bit); small quantity; few; short distance
少ない	すくない	i-adj.	few; a little; scarce; insufficient; seldom
住む	すむ	v.(u. i.)	to live in; to reside; to inhabit; to dwell; to abide
スポーツ		n.(kat.)	sport; sports
スプーン		n.(kat.)	spoon
スリッパ		n.(kat.)	slipper; slippers
ストーブ		n.(kat.)	heater; stove
吸う	すう	v.(u. t.)	to smoke, to suck
座る	すわる	v.(u. i.)	to sit
涼しい	すずしい	adj.(i-adj.)	refreshing, cool
たばこ		n.	tobacco; cigarette
食べ物	たべもの	n.	food
食べる	たべる	v.(ru. i.)	to eat
多分	たぶん	adj.(na-adj.)	perhaps; probably
大変	たいへん	n.(na-adj.)	very; greatly; terribly; serious; difficult
大切	たいせつ	n.(na-adj.)	important; necessary; indispensable; beloved
大使館	たいしかん	n.	embassy
高い	たかい	adj.(i-adj.)	high; tall; expensive; above average
沢山	たくさん	n.(na-adj.)	many
タクシー		n.(kat.)	taxi
卵	たまご	n.	eggs; egg
誕生日	たんじょうび	n.	birthday
頼む	たのむ	v.(u. t.)	to ask
楽しい	たのしい	adj.(i-adj.)	enjoyable; fun
縦	たて	n.	length,height
建物	たてもの	n.	building
立つ	たつ	v.(u. i.)	to stand; to stand up​
手	て	n.	hand; arm
テーブル		n.(kat.)	table
テープ		n.(kat.)	tape
テープレコーダー		n.(kat.)	tape recorder
手紙	てがみ	n.	Letter (message)​
天気	てんき	n.	weather; the elements
テレビ		n.(kat.)	television; TV​
テスト		n.(suru kat.)	examination; quiz; test
戸	と	n.	Japanese style door
飛ぶ	とぶ	v.(u. i.)	to fly; to hop
トイレ		n.(kat.)	toilet
時計	とけい	n.	watch; clock; timepiece
時	とき	n.	time; moment; occasion; chance
時々	ときどき	n.	sometimes; at times
所	ところ	n.	place
止まる	とまる	v.(u. i.)	to stop; to come to a halt
友達	ともだち	n.	friend; companion
隣	となり	n.	next door to
遠い	とおい	adj.(i-adj.)	far
十日	とおか	n.	tenth day of the month / 10 days
鳥	とり	n.	bird
鶏肉	とりにく	n.	chicken meat
取る	とる	v.(u. t.)	to take; to pick up; to harvest; to earn; to win; to choose
撮る	とる	v.(u. t.)	to take a photo or record a film
年	とし	n.	year; age
図書館	としょかん	n.	library
次	つぎ	n.	next
一日	ついたち	n.	first day of the month
疲れる	つかれる	v.(ru. i.)	to get tired
使う	つかう	v.(u. t.)	to use
つける		v.(ru. t.)	to turn on
付ける	つける	v.(ru. t.)	to attach; affix; add; apply
着く	つく	v.(u. i.)	to arrive at
机	つくえ	n.	desk
作る	つくる	v.(u. t.)	to make
詰まらない	つまらない	adj.(i-adj.)	boring
冷たい	つめたい	i-adj.	cold to the touch
勤める	つとめる	v.(ru. t.)	to work for someone
強い	つよい	adj.(i-adj.)	powerful
上	うえ	n.	above; up; over; top; surface
生まれる	うまれる	v.(ru. i.)	to be born
海	うみ	n.	sea
売る	うる	v.(u. t.)	to sell
煩い	うるさい	i-adj.	noisy, annoying
後ろ	うしろ	n.	back; behind; rear
薄い	うすい	adj.(i-adj.)	thin; weak
歌	うた	n.	song
歌う	うたう	v.(u. i. t.)	to sing
上着	うわぎ	n.	coat; tunic; jacket; outer garment
ワイシャツ		n.(kat. wasei)	shirt
若い	わかい	adj.(i-adj.)	young
分かる	わかる	v.(u. i.)	to understand; to comprehend; to grasp; to see; to get; to follow
悪い	わるい	adj.(i-adj.)	bad; poor; undesirable
忘れる	わすれる	v.(ru. t.)	to forget
渡る	わたる	v.(u. i.)	to go across
私	わたし	pron.	I; myself
渡す	わたす	v.(u. t.)	to hand over
山	やま	n.	mountain; hill
八百屋	やおや	n.	greengrocer; fruit and vegetable shop; versatile
やる		v.(u. t.)	to do
野菜	やさい	n.	vegetable
易しい	やさしい	adj.(i-adj.)	easy, simple
安い	やすい	adj.(i-adj.)	cheap; inexpensive
休み	やすみ	n.	rest; vacation; holiday
休む	やすむ	v.(u. i.)	to be absent; to take a day off; to rest
八つ	やっつ	n.	eight: 8
呼ぶ	よぶ	v.(u. t.)	to call out, to invite
良い	よい/いい	adj.(i-adj.)	good
四日	よっか	n.	fourth day of the month / 4 days
横	よこ	n.	beside,side,width
よく		adv.	often, well
読む	よむ	v.(u. t.)	to read; to guess; to predict; to read (someone's thoughts)
夜	よる	n.	evening; night
四つ	よつ	n.	four; 4
洋服	ようふく	n.	western clothes
八日	ようか	n.	eighth day of the month / 8 days
弱い	よわい	adj.(i-adj.)	weak
雪	ゆき	n.	snow
ゆっくり		adv.	slowly
昨夜	ゆうべ	n.	last night
郵便局	ゆうびんきょく	n.	post office
夕方	ゆうがた	n.	evening; dusk
夕飯	ゆうはん	n.	evening meal
有名	ゆうめい	n.(na-adj.)	famous
雑誌	ざっし	n.	magazine
全部	ぜんぶ	n.	all
ゼロ		n.	zero
ズボン		n.(kat.)	trousers; pants
